1 1 1 1 1 1 1 1 1 1 1 1 1 1 1 1 1 1 1 1
1 0 0 0 0 0 0 0 0 6 7 0 0 0 0 0 0 0 0 1
1 0 0 0 0 0 0 0 0 0 0 0 0 0 0 0 0 0 0 1
1 0 2 3 0 1 0 0 0 2 3 0 0 0 1 0 2 3 0 1
1 0 4 5 0 1 0 0 0 4 5 0 0 0 1 0 4 5 0 1
1 0 0 0 0 0 0 0 0 0 0 0 0 0 0 0 0 0 0 1
1 0 0 0 0 0 0 6 7 0 0 6 7 0 0 0 0 0 0 1
1 0 1 0 1 0 0 0 1 0 0 1 0 0 0 1 0 1 0 1
1 0 1 0 1 0 0 0 1 0 0 1 0 0 0 1 0 1 0 1
1 0 0 0 0 0 0 0 0 1 1 0 0 0 0 0 0 0 0 1
1 0 0 0 0 2 3 0 0 0 0 0 0 2 3 0 0 0 0 1
1 1 1 1 1 4 5 1 1 1 1 1 1 4 5 1 1 1 1 1
