b b b b b b b b b b b b b b b b b b b b
b a a a a a a a a g h a a a a a a a a b
b a a a a a a a a a a a a a a a a a a b
b a c d a b a a a c d a a a b a c d a b
b a e f a b a a a e f a a a b a e f a b
b a a a a a a a a a a a a a a a a a a b
b a a a a a a g h a a g h a a a a a a b
b a b a b a a a b a a b a a a b a b a b
b a b a b a a a b a a b a a a b a b a b
b a a a a a a a a b b a a a a a a a a b
b a a a a c d a a a a a a c d a a a a b
b b b b b e f b b b b b b e f b b b b b
