c d b g h b b b b b b b b b b g h b c d
e f a a a a a a a a a a a a a a a a e f
b a a a b g h b b a a b b g h b a a a i
b a a b a a a a a a a a a a a a b a a j
b a a b a b g h b a a b g h b a b a a b
b a a i a b a a a a a a a a b a i a a b
b a a j a b a a a a a a a a b a j a a b
b a a b a b g h b a a b g h b a b a a b
i a a b a a a a a a a a a a a a b a a b
j a a a b g h b b a a b b g h b a a a b
c d a a a a a a a a a a a a a a a a c d
e f b g h b b b b b b b b b b g h b e f
