c d b g h b b b b b b b b b b g h b c d
e f a a a a a a a a a a a a a a a a e f
b a a a b g h b b a a b b g h b a a a b
b a a b a a a a a a a a a a a a b a a b
b a a b a b g h b a a b g h b a b a a b
b a a b a b a a a a a a a a b a b a a b
b a a b a b a a a a a a a a b a b a a b
b a a b a b g h b a a b g h b a b a a b
b a a b a a a a a a a a a a a a b a a b
b a a a b g h b b a a b b g h b a a a b
c d a a a a a a a a a a a a a a a a c d
e f b g h b b b b b b b b b b g h b e f
